1 ,1 ,1 ,1 ,1 ,1 ,1 ,1 ,1 ,1 ,1 ,1 ,1 ,1 ,1 ,1 ,1 ,1 ,1 ,1 ,1 ,1 ,1 ,1 ,1 ,1 ,1 ,1 ,1 ,1 ,1 ,1
1 ,1 ,1 ,1 ,1 ,1 ,1 ,1 ,1 ,1 ,1 ,1 ,1 ,1 ,1 ,1 ,1 ,1 ,1 ,1 ,1 ,1 ,1 ,1 ,1 ,1 ,1 ,1 ,1 ,1 ,1 ,1
1 ,1 ,1 ,1 ,1 ,1 ,1 ,1 ,1 ,1 ,1 ,1 ,1 ,1 ,5 ,5 ,5 ,5 ,5 ,5 ,5 ,5 ,5 ,5 ,5 ,1 ,1 ,1 ,1 ,1 ,1 ,1
1 ,1 ,1 ,1 ,1 ,1 ,1 ,1 ,1 ,1 ,1 ,1 ,1 ,1 ,5 ,1 ,1 ,1 ,1 ,1 ,1 ,1 ,1 ,1 ,5 ,1 ,1 ,1 ,1 ,1 ,1 ,1
1 ,1 ,1 ,1 ,1 ,1 ,1 ,1 ,1 ,1 ,1 ,1 ,1 ,1 ,5 ,1 ,1 ,1 ,1 ,1 ,1 ,1 ,1 ,1 ,5 ,1 ,1 ,1 ,1 ,1 ,1 ,1
1 ,1 ,1 ,1 ,1 ,1 ,1 ,1 ,1 ,1 ,1 ,1 ,1 ,1 ,5 ,1 ,1 ,1 ,1 ,1 ,1 ,1 ,1 ,1 ,5 ,1 ,1 ,1 ,1 ,1 ,1 ,1
1 ,1 ,1 ,1 ,1 ,1 ,1 ,1 ,1 ,1 ,1 ,1 ,1 ,1 ,5 ,5 ,5 ,5 ,5 ,5 ,1 ,1 ,1 ,1 ,5 ,1 ,1 ,1 ,1 ,1 ,1 ,1
1 ,1 ,1 ,1 ,1 ,1 ,1 ,1 ,1 ,1 ,1 ,1 ,1 ,1 ,1 ,1 ,1 ,1 ,7 ,5 ,1 ,1 ,1 ,1 ,5 ,1 ,1 ,1 ,1 ,1 ,1 ,1
1 ,1 ,1 ,1 ,1 ,1 ,1 ,1 ,1 ,1 ,1 ,1 ,1 ,1 ,1 ,1 ,1 ,1 ,7 ,5 ,1 ,1 ,1 ,1 ,5 ,1 ,1 ,1 ,1 ,1 ,1 ,1
1 ,1 ,1 ,1 ,1 ,1 ,1 ,1 ,1 ,1 ,1 ,1 ,1 ,1 ,1 ,1 ,1 ,1 ,7 ,5 ,1 ,1 ,1 ,1 ,5 ,1 ,1 ,1 ,1 ,1 ,1 ,1
3 ,3 ,3 ,3 ,3 ,3 ,3 ,3 ,3 ,3 ,3 ,3 ,3 ,3 ,3 ,3 ,3 ,3 ,6 ,5 ,1 ,1 ,1 ,1 ,5 ,1 ,1 ,1 ,1 ,1 ,1 ,1
5 ,5 ,5 ,5 ,5 ,5 ,5 ,5 ,5 ,5 ,5 ,5 ,5 ,5 ,5 ,5 ,5 ,5 ,5 ,5 ,1 ,1 ,1 ,1 ,5 ,1 ,1 ,1 ,1 ,1 ,1 ,1
4 ,4 ,4 ,4 ,4 ,4 ,4 ,4 ,4 ,4 ,4 ,4 ,4 ,4 ,4 ,4 ,4 ,4 ,4 ,4 ,1 ,1 ,1 ,1 ,5 ,1 ,1 ,1 ,1 ,1 ,1 ,1
1 ,1 ,1 ,1 ,1 ,1 ,1 ,1 ,1 ,1 ,1 ,1 ,1 ,1 ,1 ,1 ,1 ,1 ,1 ,1 ,1 ,1 ,1 ,1 ,5 ,1 ,1 ,1 ,1 ,1 ,1 ,1
1 ,1 ,1 ,1 ,1 ,1 ,1 ,1 ,1 ,1 ,1 ,1 ,1 ,1 ,1 ,1 ,1 ,1 ,1 ,1 ,1 ,1 ,1 ,1 ,5 ,1 ,1 ,1 ,1 ,1 ,1 ,1
1 ,1 ,1 ,1 ,1 ,1 ,1 ,1 ,1 ,1 ,1 ,1 ,1 ,1 ,1 ,1 ,1 ,1 ,1 ,1 ,1 ,1 ,1 ,1 ,5 ,1 ,1 ,1 ,1 ,1 ,1 ,1
1 ,1 ,1 ,1 ,1 ,1 ,1 ,1 ,1 ,1 ,1 ,1 ,1 ,1 ,1 ,1 ,1 ,1 ,1 ,1 ,1 ,1 ,1 ,1 ,5 ,1 ,1 ,1 ,1 ,1 ,1 ,1
1 ,1 ,1 ,1 ,1 ,1 ,1 ,1 ,1 ,1 ,1 ,1 ,1 ,1 ,1 ,1 ,1 ,1 ,1 ,1 ,1 ,1 ,1 ,1 ,5 ,1 ,1 ,1 ,1 ,1 ,1 ,1
1 ,1 ,1 ,1 ,1 ,1 ,1 ,1 ,1 ,1 ,1 ,1 ,1 ,1 ,1 ,1 ,1 ,1 ,1 ,1 ,1 ,1 ,1 ,1 ,5 ,1 ,1 ,1 ,1 ,1 ,1 ,1
1 ,1 ,1 ,1 ,1 ,1 ,1 ,1 ,1 ,1 ,1 ,1 ,1 ,1 ,1 ,1 ,1 ,1 ,1 ,1 ,1 ,1 ,1 ,1 ,5 ,1 ,1 ,1 ,1 ,1 ,1 ,1
